ANTHEM	AE N TH AH M
ARE	AA R
ARE(2)	ER
HELLO	HH AH L OW
HELLO(2)	HH EH L OW
HOW	HH AW
IN	IH N
IS	IH Z
IT	IH T
LUCY	L UW S IY
NATIONAL	N AE SH AH N AH L
NATIONAL(2)	N AE SH N AH L
PLAY	P L EY
PLEASE	P L IY Z
PUNE	P Y UW N
THE	DH AH
THE(2)	DH IY
TIME	T AY M
WEATHER	W EH DH ER
WHAT	W AH T
WHAT(2)	HH W AH T
YOU	Y UW
